11 11 11 11 11 11 11 11 11 11 11 11 11 11 11 11 11 11 11 11 11 11 11 11 11 11 11 11 11 11 11 11 11 11 11 11 11 11 11 11 11 11 11 11 11 11 11 11 11 11 11 11 11
11 11 11 11 11 11 11 11 11 11 11 11 11 11 11 11 11 11 11 11 11 11 11 11 11 11 11 11 11 11 11 11 11 11 11 11 11 11 11 11 11 11 11 11 11 11 11 11 11 11 11 11 11
11 11 11 11 11 11 11 11 11 11 11 11 11 11 11 11 11 11 11 11 11 11 11 11 11 11 11 11 11 11 11 11 11 11 11 11 11 11 11 11 11 11 11 11 11 11 11 11 11 11 11 11 11
11 11 11 11 11 11 11 11 11 11 11 11 11 11 11 11 11 11 11 11 11 11 11 11 11 11 11 11 11 11 11 11 11 11 11 11 11 11 11 11 11 11 11 11 11 11 11 11 11 11 11 11 11
11 11 11 11 11 11 11 11 11 11 11 11 11 11 11 11 11 11 11 11 11 11 11 11 11 11 11 11 11 11 11 11 11 11 11 11 11 11 11 11 11 11 11 11 11 11 11 11 11 11 11 11 11
11 11 11 11 11 11 11 11 11 11 11 11 11 11 11 11 11 11 11 11 11 11 11 11 11 11 11 11 11 11 11 11 11 11 11 11 11 11 11 11 11 11 11 11 11 11 11 11 11 11 11 11 11
11 11 11 11 11 11 11 11 11 11 11 11 11 11 11 11 11 11 11 11 11 11 11 11 11 11 11 11 11 11 11 11 11 11 11 11 11 11 11 11 11 11 11 11 11 11 11 11 11 11 11 11 11
11 11 11 11 11 11 11 11 11 11 11 11 11 11 11 11 11 11 11 11 11 11 11 11 11 11 11 11 11 11 11 11 11 11 11 11 11 11 11 11 11 11 11 11 11 11 11 11 11 11 11 11 11
11 11 11 11 11 11 11 11 11 11 11 11 11 11 11 11 11 11 11 11 11 11 11 11 11 11 11 11 11 11 11 11 11 11 11 11 11 11 11 11 11 11 11 11 11 11 11 11 11 11 11 11 11
11 11 11 11 11 11 11 11 11 11 11 11 11 11 11 11 11 11 11 11 11 11 11 11 11 11 11 11 11 11 11 11 11 11 11 11 11 11 11 11 11 11 11 11 11 11 11 11 11 11 11 11 11
11 11 11 11 11 11 11 11 11 11 11 11 11 11 11 11 11 11 11 11 11 11 11 11 11 11 11 11 11 11 11 11 11 11 11 11 11 11 11 11 11 11 11 11 11 11 11 11 11 11 11 11 11
11 11 11 11 11 11 11 11 11 11 11 11 11 11 11 11 11 11 11 11 11 11 11 11 11 11 11 11 11 11 11 11 11 11 11 11 11 11 11 11 11 11 11 11 11 11 11 11 11 11 11 11 11
11 11 11 11 11 11 11 11 11 11 11 11 11 11 11 11 11 11 11 11 11 11 11 11 11 11 11 11 11 11 11 11 11 11 11 11 11 11 11 11 11 11 11 11 11 11 11 11 11 11 11 11 11
11 11 11 11 11 11 11 11 11 11 11 11 11 11 11 11 11 11 11 11 11 11 11 11 11 11 11 11 11 11 11 11 11 11 11 11 11 11 11 11 11 11 11 11 11 11 11 11 11 11 11 11 11
11 11 11 11 11 11 11 11 11 11 11 11 11 11 11 11 11 11 11 11 11 11 11 11 11 11 11 11 11 11 11 11 11 11 11 11 11 11 11 11 11 11 11 11 11 11 11 11 11 11 11 11 11
11 11 11 11 11 11 11 11 11 11 11 11 11 11 11 11 11 11 11 11 11 11 11 11 11 11 11 11 11 11 11 11 11 11 11 11 11 11 11 11 11 11 11 11 11 11 11 11 11 11 11 11 11
11 11 11 11 11 11 11 11 11 11 11 11 11 11 11 11 11 11 11 11 11 11 11 11 11 11 11 11 11 11 11 11 11 11 11 11 11 11 11 11 11 11 11 11 11 11 11 11 11 11 11 11 11
11 11 11 11 11 11 11 11 11 11 11 11 11 11 11 11 11 11 11 11 11 11 11 11 11 11 11 11 11 11 11 11 11 11 11 11 11 11 11 11 11 11 11 11 11 11 11 11 11 11 11 11 11
11 11 11 11 11 11 11 11 11 11 11 11 11 3 3 3 3 3 3 3 3 3 3 3 3 3 3 3 3 3 3 3 3 3 3 3 3 3 3 11 11 11 11 11 11 11 11 11 11 11 11 11 11
11 11 11 11 11 11 11 11 11 11 11 11 11 3 8 8 8 8 8 8 8 8 8 8 8 8 8 8 8 8 8 8 8 8 8 8 8 8 3 11 11 11 11 11 11 11 11 11 11 11 11 11 11
11 11 11 11 11 11 11 11 11 11 11 11 11 3 8 8 8 8 8 8 8 8 8 8 8 8 8 8 8 8 8 8 8 8 8 8 8 8 3 11 11 11 11 11 11 11 11 11 11 11 11 11 11
11 11 11 11 11 11 11 11 11 11 11 11 11 3 8 8 8 8 8 8 8 8 8 8 8 8 8 8 8 8 8 8 8 8 8 8 8 8 3 11 11 11 11 11 11 11 11 11 11 11 11 11 11
11 11 11 11 11 11 11 11 11 11 11 11 11 3 8 8 8 8 8 8 8 8 8 8 8 8 8 8 8 8 8 8 8 8 8 8 8 8 3 11 11 11 11 11 11 11 11 11 11 11 11 11 11
11 11 11 11 11 11 11 11 11 11 11 11 11 3 8 8 8 8 8 8 8 8 8 8 8 8 8 8 8 8 8 8 8 8 8 8 8 8 3 11 11 11 11 11 11 11 11 11 11 11 11 11 11
11 11 11 11 11 11 11 11 11 11 11 11 11 3 8 8 8 8 8 8 8 8 8 8 8 8 8 8 8 8 8 8 8 8 8 8 8 8 3 11 11 11 11 11 11 11 11 11 11 11 11 11 11
11 11 11 11 11 11 11 11 11 11 11 11 11 3 8 8 8 8 8 8 8 8 8 8 8 8 8 8 8 8 8 8 8 8 8 8 8 8 3 11 11 11 11 11 11 11 11 11 11 11 11 11 11
11 11 11 11 11 11 11 11 11 11 11 11 11 3 8 8 8 8 8 8 8 8 8 8 8 8 8 8 8 8 8 8 8 8 8 8 8 8 3 11 11 11 11 11 11 11 11 11 11 11 11 11 11
11 11 11 11 11 11 11 11 11 11 11 11 11 3 8 8 8 8 8 8 8 8 8 8 8 8 8 8 8 8 8 8 8 8 8 8 8 8 3 11 11 11 11 11 11 11 11 11 11 11 11 11 11
11 11 11 11 11 11 11 11 11 11 11 11 11 3 8 8 8 8 8 8 8 8 8 8 8 8 8 8 8 8 8 8 8 8 8 8 8 8 3 11 11 11 11 11 11 11 11 11 11 11 11 11 11
11 11 11 11 11 11 11 11 11 11 11 11 11 3 8 8 8 8 8 8 8 8 8 8 8 8 8 8 8 8 8 8 8 8 8 8 8 8 3 11 11 11 11 11 11 11 11 11 11 11 11 11 11
11 11 11 11 11 11 11 11 11 11 11 11 11 3 8 8 8 8 8 8 8 8 8 8 8 8 8 8 8 8 8 8 8 8 8 8 8 8 3 11 11 11 11 11 11 11 11 11 11 11 11 11 11
11 11 11 11 11 11 11 11 11 11 11 11 11 3 8 8 8 8 8 8 8 8 8 8 8 8 8 8 8 8 8 8 8 8 8 8 8 8 3 11 11 11 11 11 11 11 11 11 11 11 11 11 11
11 11 11 11 11 11 11 11 11 11 11 11 11 3 3 3 3 3 3 3 3 3 3 3 3 8 8 3 3 3 3 3 3 3 3 3 3 3 3 11 11 11 11 11 11 11 11 11 11 11 11 11 11
11 11 11 11 11 11 11 12 12 12 12 12 12 12 12 12 12 12 12 12 12 12 12 12 12 13 13 12 12 12 12 14 14 14 14 14 14 12 12 12 12 12 12 12 12 12 11 11 11 11 11 11 11
11 11 11 11 11 11 11 12 12 12 12 12 12 12 12 12 12 12 12 12 12 12 12 12 12 13 13 12 12 12 12 14 14 14 14 14 14 12 12 12 12 12 12 12 12 12 11 11 11 11 11 11 11
11 11 11 11 11 11 11 12 12 12 12 12 12 13 13 13 13 13 13 13 13 13 13 13 13 13 13 12 12 12 12 14 14 14 14 14 14 12 12 12 12 12 12 12 12 12 11 11 11 11 11 11 11
11 11 11 11 11 11 11 12 12 12 12 12 12 13 12 12 12 12 12 12 12 12 12 12 12 12 12 12 12 12 12 14 14 14 14 14 14 12 12 12 12 12 12 12 12 12 11 11 11 11 11 11 11
11 11 11 11 11 11 11 12 14 14 14 14 12 13 12 12 12 12 12 12 12 12 12 12 12 12 12 12 12 12 12 14 14 14 14 14 14 12 12 12 12 12 12 12 12 12 11 11 11 11 11 11 11
11 11 11 11 11 11 11 12 14 14 14 14 12 13 13 13 13 13 13 13 13 13 13 13 13 13 13 13 13 13 13 13 13 13 13 13 13 13 13 13 13 12 12 12 12 12 11 11 11 11 11 11 11
11 11 11 11 11 11 11 12 14 14 14 14 12 12 12 12 12 12 12 12 12 12 12 12 12 12 12 12 12 12 12 12 12 12 12 12 12 12 12 12 13 12 12 12 12 12 11 11 11 11 11 11 11
11 11 11 11 11 11 11 12 14 14 14 14 11 11 12 12 12 12 12 12 12 12 12 11 12 12 12 11 12 12 12 12 12 14 14 14 14 14 12 12 13 12 12 12 12 12 11 11 11 11 11 11 11
11 11 11 11 11 11 11 12 14 14 14 14 11 11 12 12 12 12 12 12 12 12 12 12 11 12 12 12 12 12 12 12 12 14 14 14 14 14 12 12 13 12 12 12 12 12 11 11 11 11 11 11 11
11 11 11 11 11 11 11 12 12 12 12 11 11 11 12 12 12 11 11 11 11 12 12 12 12 12 12 12 12 12 12 12 12 14 14 14 14 14 12 12 13 12 12 12 12 12 11 11 11 11 11 11 11
11 11 11 11 11 11 11 12 12 12 12 12 12 12 12 12 12 11 11 11 11 12 12 12 12 13 13 13 13 13 13 13 12 14 14 14 14 14 12 12 13 12 12 12 12 12 11 11 11 11 11 11 11
11 11 11 11 11 11 11 12 12 12 12 12 12 12 12 12 12 12 12 12 12 12 12 12 12 13 13 12 12 12 12 13 12 12 12 12 12 12 12 12 13 12 12 12 12 12 11 11 11 11 11 11 11
11 11 11 11 11 11 11 12 12 12 12 12 12 12 12 12 12 12 12 12 12 12 12 12 12 13 13 12 12 12 12 13 13 13 13 13 13 13 13 13 13 12 12 12 12 12 11 11 11 11 11 11 11
11 11 11 11 11 11 11 12 12 12 12 12 12 12 12 12 12 12 12 12 12 12 12 12 12 13 13 12 12 12 12 12 12 12 12 12 12 12 12 12 12 12 12 12 12 12 11 11 11 11 11 11 11
11 11 11 11 11 11 11 12 12 12 12 12 12 12 12 12 12 12 12 12 12 12 12 12 12 13 13 12 12 12 12 12 12 12 12 12 12 12 12 12 12 12 12 12 12 12 11 11 11 11 11 11 11
11 11 11 11 11 11 11 11 11 11 11 11 11 11 11 11 11 11 11 11 11 11 11 11 11 13 13 11 11 11 11 11 11 11 11 11 11 11 11 11 11 11 11 11 11 11 11 11 11 11 11 11 11
11 11 11 11 11 11 11 11 11 11 11 11 11 11 11 11 11 3 3 3 3 3 3 3 3 5 5 3 3 3 3 3 3 3 3 11 11 11 11 11 11 11 11 11 11 11 11 11 11 11 11 11 11
11 11 11 11 11 11 11 11 11 11 11 11 11 11 11 11 11 3 7 7 7 7 7 7 7 7 7 7 7 7 7 7 7 7 3 11 11 11 11 11 11 11 11 11 11 11 11 11 11 11 11 11 11
11 11 11 11 11 11 11 11 11 11 11 11 11 11 11 11 11 3 7 7 7 7 7 7 7 7 7 7 7 7 7 7 7 7 3 11 11 11 11 11 11 11 11 11 11 11 11 11 11 11 11 11 11
11 11 11 11 11 11 11 11 11 11 11 11 11 11 11 11 11 3 5 5 5 5 5 5 5 5 5 5 5 5 5 5 5 5 3 11 11 11 11 11 11 11 11 11 11 11 11 11 11 11 11 11 11
11 11 11 11 11 11 11 11 11 11 11 11 11 11 11 11 11 3 5 5 5 5 5 5 5 5 5 5 5 5 5 5 5 5 3 11 11 11 11 11 11 11 11 11 11 11 11 11 11 11 11 11 11
11 11 11 11 11 11 11 11 11 11 11 11 11 11 11 11 11 3 7 7 7 7 7 7 7 7 7 7 7 7 7 7 7 7 3 11 11 11 11 11 11 11 11 11 11 11 11 11 11 11 11 11 11
11 11 11 11 11 11 11 11 11 11 11 11 11 11 11 11 11 3 7 7 7 7 7 7 7 7 7 7 7 7 7 7 7 7 3 11 11 11 11 11 11 11 11 11 11 11 11 11 11 11 11 11 11
11 11 11 11 11 11 11 11 11 11 11 11 11 11 11 11 11 3 5 5 5 5 5 5 5 5 5 5 5 5 5 5 5 5 3 11 11 11 11 11 11 11 11 11 11 11 11 11 11 11 11 11 11
11 11 11 11 11 11 11 11 11 11 11 11 11 11 11 11 11 3 5 5 5 5 5 5 5 5 5 5 5 5 5 5 5 5 3 11 11 11 11 11 11 11 11 11 11 11 11 11 11 11 11 11 11
11 11 11 11 11 11 11 11 11 11 11 11 11 11 11 11 11 3 7 7 7 7 7 7 7 7 7 7 7 7 7 7 7 7 3 11 11 11 11 11 11 11 11 11 11 11 11 11 11 11 11 11 11
11 11 11 11 11 11 11 11 11 11 11 11 11 11 11 11 11 3 7 7 7 7 7 7 7 7 7 7 7 7 7 7 7 7 3 11 11 11 11 11 11 11 11 11 11 11 11 11 11 11 11 11 11
11 11 11 11 11 11 11 11 11 11 11 11 11 3 3 3 3 3 3 3 3 3 3 3 3 5 5 3 3 3 3 3 3 3 3 3 3 3 3 11 11 11 11 11 11 11 11 11 11 11 11 11 11
11 11 11 11 11 11 11 11 11 11 11 11 11 3 7 7 7 7 7 7 7 3 5 7 5 7 5 7 5 7 3 7 7 7 7 7 7 7 3 11 11 11 11 11 11 11 11 11 11 11 11 11 11
11 11 11 11 11 11 11 11 11 11 11 11 11 3 7 7 7 7 7 7 7 3 7 5 7 5 7 5 7 5 3 7 7 7 7 7 7 7 3 11 11 11 11 11 11 11 11 11 11 11 11 11 11
11 11 11 11 11 11 11 11 11 11 11 11 11 3 5 5 5 5 5 5 5 3 5 7 5 7 5 7 5 7 3 5 5 5 5 5 5 5 3 11 11 11 11 11 11 11 11 11 11 11 11 11 11
11 11 11 11 11 11 11 11 11 11 11 11 11 3 6 5 6 5 6 5 6 5 7 5 7 5 7 5 7 5 5 6 5 6 5 6 5 6 3 11 11 11 11 11 11 11 11 11 11 11 11 11 11
11 11 11 11 11 11 11 11 11 11 11 11 11 3 5 5 5 5 5 5 5 5 5 7 5 7 5 7 5 7 5 5 5 5 5 5 5 5 3 11 11 11 11 11 11 11 11 11 11 11 11 11 11
11 11 11 11 11 11 11 11 11 11 11 11 11 3 6 5 6 5 6 5 6 3 7 5 7 5 7 5 7 5 3 6 5 6 5 6 5 6 3 11 11 11 11 11 11 11 11 11 11 11 11 11 11
11 11 11 11 11 11 11 11 11 11 11 11 11 3 5 5 5 5 5 5 5 3 5 7 5 7 5 7 5 7 3 5 5 5 5 5 5 5 3 11 11 11 11 11 11 11 11 11 11 11 11 11 11
11 11 11 11 11 11 11 11 11 11 11 11 11 3 6 5 6 5 6 5 6 3 7 5 7 5 7 5 7 5 3 6 5 6 5 6 5 6 3 11 11 11 11 11 11 11 11 11 11 11 11 11 11
11 11 11 11 11 11 11 11 11 11 11 11 11 3 3 3 3 3 3 3 3 3 5 7 5 7 5 7 5 7 3 3 3 3 3 3 3 3 3 11 11 11 11 11 11 11 11 11 11 11 11 11 11
11 11 11 11 11 11 11 11 11 11 11 11 11 3 7 7 7 7 7 7 7 3 7 5 7 5 7 5 7 5 3 7 7 7 7 7 7 7 3 11 11 11 11 11 11 11 11 11 11 11 11 11 11
11 11 11 11 11 11 11 11 11 11 11 11 11 3 7 7 7 7 7 7 7 3 5 7 5 7 5 7 5 7 3 7 7 7 7 7 7 7 3 11 11 11 11 11 11 11 11 11 11 11 11 11 11
11 11 11 11 11 11 11 11 11 11 11 11 11 3 5 5 5 5 5 5 5 5 7 5 7 5 7 5 7 5 5 5 5 5 5 5 5 5 3 11 11 11 11 11 11 11 11 11 11 11 11 11 11
11 11 11 11 11 11 11 11 11 11 11 11 11 3 6 6 5 6 5 6 6 5 5 7 5 7 5 7 5 7 5 6 6 5 6 5 6 6 3 11 11 11 11 11 11 11 11 11 11 11 11 11 11
11 11 11 11 11 11 11 11 11 11 11 11 11 3 5 5 5 5 5 5 5 3 7 5 7 5 7 5 7 5 3 5 5 5 5 5 5 5 3 11 11 11 11 11 11 11 11 11 11 11 11 11 11
11 11 11 11 11 11 11 11 11 11 11 11 11 3 6 6 5 6 5 6 6 3 5 7 5 7 5 7 5 7 3 6 6 5 6 5 6 6 3 11 11 11 11 11 11 11 11 11 11 11 11 11 11
11 11 11 11 11 11 11 11 11 11 11 11 11 3 3 3 3 3 3 3 3 3 7 5 7 5 7 5 7 5 3 3 3 3 3 3 3 3 3 11 11 11 11 11 11 11 11 11 11 11 11 11 11
11 11 11 11 11 11 11 11 11 11 11 11 11 3 6 6 6 6 6 6 6 5 5 7 5 7 5 7 5 7 5 6 6 6 6 6 6 6 3 11 11 11 11 11 11 11 11 11 11 11 11 11 11
11 11 11 11 11 11 11 11 11 11 11 11 11 3 5 5 5 5 5 5 5 5 7 5 7 5 7 5 7 5 5 5 5 5 5 5 5 5 3 11 11 11 11 11 11 11 11 11 11 11 11 11 11
11 11 11 11 11 11 11 11 11 11 11 11 11 3 6 5 6 5 6 5 6 3 3 3 3 5 5 3 3 3 3 6 5 6 5 6 5 6 3 11 11 11 11 11 11 11 11 11 11 11 11 11 11
11 11 11 11 11 11 11 11 11 11 11 11 11 3 5 5 5 5 5 5 5 3 11 11 11 13 13 11 11 11 3 5 5 5 5 5 5 5 3 11 11 11 11 11 11 11 11 11 11 11 11 11 11
11 11 11 11 11 11 11 11 11 11 11 11 11 3 6 5 6 5 6 5 6 3 11 12 11 13 13 11 12 11 3 6 5 6 5 6 5 6 3 11 11 11 11 11 11 11 11 11 11 11 11 11 11
11 11 11 11 11 11 11 11 11 11 11 11 11 3 7 7 7 7 7 7 7 3 11 12 11 13 13 11 12 11 3 7 7 7 7 7 7 7 3 11 11 11 11 11 11 11 11 11 11 11 11 11 11
11 11 11 11 11 11 11 11 11 11 11 11 11 3 7 7 7 7 7 7 7 3 11 12 11 13 13 11 12 11 3 7 7 7 7 7 7 7 3 11 11 11 11 11 11 11 11 11 11 11 11 11 11
11 11 11 11 11 11 11 11 11 11 11 11 11 3 3 3 3 3 3 3 3 3 11 11 11 13 13 11 11 11 3 3 3 3 3 3 3 3 3 11 11 11 11 11 11 11 11 11 11 11 11 11 11
11 11 11 11 11 11 11 11 11 11 11 11 11 11 11 11 11 11 11 11 11 11 11 11 11 13 13 11 11 11 11 11 11 11 11 11 11 11 11 11 11 11 11 11 11 11 11 11 11 11 11 11 11
11 11 11 11 11 11 11 11 11 11 11 11 11 11 11 11 11 11 11 11 11 11 11 11 11 13 13 11 11 11 11 11 11 11 11 11 11 11 11 11 11 11 11 11 11 11 11 11 11 11 11 11 11
11 11 11 11 11 11 11 12 12 12 12 12 12 12 12 12 12 12 12 12 12 12 12 12 12 13 13 12 12 12 12 14 14 14 14 14 14 12 12 12 12 12 12 12 12 12 11 11 11 11 11 11 11
11 11 11 11 11 11 11 12 12 12 12 12 12 12 12 12 12 12 12 12 12 12 12 12 12 13 13 12 12 12 12 14 14 14 14 14 14 12 12 12 12 12 12 12 12 12 11 11 11 11 11 11 11
11 11 11 11 11 11 11 12 12 12 12 12 12 13 13 13 13 13 13 13 13 13 13 13 13 13 13 12 12 12 12 14 14 14 14 14 14 12 12 12 12 12 12 12 12 12 11 11 11 11 11 11 11
11 11 11 11 11 11 11 12 12 12 12 12 12 13 12 12 12 12 12 12 12 12 12 12 12 12 12 12 12 12 12 14 14 14 14 14 14 12 12 12 12 12 12 12 12 12 11 11 11 11 11 11 11
11 11 11 11 11 11 11 12 14 14 14 14 12 13 12 12 12 12 12 12 12 12 12 12 12 12 12 12 12 12 12 14 14 14 14 14 14 12 12 12 12 12 12 12 12 12 11 11 11 11 11 11 11
11 11 11 11 11 11 11 12 14 14 14 14 12 13 13 13 13 13 13 13 13 13 13 13 13 13 13 13 13 13 13 13 13 13 13 13 13 13 13 13 13 12 12 12 12 12 11 11 11 11 11 11 11
11 11 11 11 11 11 11 12 14 14 14 14 12 12 12 12 12 12 12 12 12 12 12 12 12 12 12 12 12 12 12 12 12 12 12 12 12 12 12 12 13 12 12 12 12 12 11 11 11 11 11 11 11
11 11 11 11 11 11 11 12 14 14 14 14 11 11 12 12 12 12 12 12 12 12 12 11 12 12 12 11 12 12 12 12 12 14 14 14 14 14 12 12 13 12 12 12 12 12 11 11 11 11 11 11 11
11 11 11 11 11 11 11 12 14 14 14 14 11 11 12 12 12 12 12 12 12 12 12 12 11 12 12 12 12 12 12 12 12 14 14 14 14 14 12 12 13 12 12 12 12 12 11 11 11 11 11 11 11
11 11 11 11 11 11 11 12 12 12 12 11 11 11 12 12 12 11 11 11 11 12 12 12 12 12 12 12 12 12 12 12 12 14 14 14 14 14 12 12 13 12 12 12 12 12 11 11 11 11 11 11 11
11 11 11 11 11 11 11 12 12 12 12 12 12 12 12 12 12 11 11 11 11 12 12 12 12 13 13 13 13 13 13 13 12 14 14 14 14 14 12 12 13 12 12 12 12 12 11 11 11 11 11 11 11
11 11 11 11 11 11 11 12 12 12 12 12 12 12 12 12 12 12 12 12 12 12 12 12 12 13 13 12 12 12 12 13 12 12 12 12 12 12 12 12 13 12 12 12 12 12 11 11 11 11 11 11 11
11 11 11 11 11 11 11 12 12 12 12 12 12 12 12 12 12 12 12 12 12 12 12 12 12 13 13 12 12 12 12 13 13 13 13 13 13 13 13 13 13 12 12 12 12 12 11 11 11 11 11 11 11
11 11 11 11 11 11 11 12 12 12 12 12 12 12 12 12 12 12 12 12 12 12 12 12 12 13 13 12 12 12 12 12 12 12 12 12 12 12 12 12 12 12 12 12 12 12 11 11 11 11 11 11 11
11 11 11 11 11 11 11 11 11 11 11 11 11 11 11 11 11 3 3 3 3 3 3 3 3 8 8 3 3 3 3 3 3 3 3 11 11 11 11 11 11 11 11 11 11 11 11 11 11 11 11 11 11
11 11 11 11 11 11 11 11 11 11 11 11 11 11 11 11 11 3 10 8 10 8 10 8 10 8 10 8 10 8 10 8 10 8 3 11 11 11 11 11 11 11 11 11 11 11 11 11 11 11 11 11 11
11 11 11 11 11 11 11 11 11 11 11 11 11 11 11 11 11 3 10 8 10 8 10 8 10 8 10 8 10 8 10 8 10 8 3 11 11 11 11 11 11 11 11 11 11 11 11 11 11 11 11 11 11
11 11 11 11 11 11 11 11 11 11 11 11 11 11 11 11 11 3 10 8 10 8 10 8 10 8 10 8 10 8 10 8 10 8 3 11 11 11 11 11 11 11 11 11 11 11 11 11 11 11 11 11 11
11 11 11 11 11 11 11 11 11 11 11 11 11 11 11 11 11 3 10 8 10 8 10 8 10 8 10 8 10 8 10 8 10 8 3 11 11 11 11 11 11 11 11 11 11 11 11 11 11 11 11 11 11
11 11 11 11 11 11 11 11 11 11 11 11 11 11 11 11 11 3 10 8 10 8 10 8 10 8 10 8 10 8 10 8 10 8 3 11 11 11 11 11 11 11 11 11 11 11 11 11 11 11 11 11 11
11 11 11 11 11 11 11 11 11 11 11 11 11 11 11 11 11 3 10 8 10 8 10 8 10 8 10 8 10 8 10 8 10 8 3 11 11 11 11 11 11 11 11 11 11 11 11 11 11 11 11 11 11
11 11 11 11 11 11 11 11 11 11 11 11 11 11 11 11 11 3 10 8 10 8 10 8 10 8 10 8 10 8 10 8 10 8 3 11 11 11 11 11 11 11 11 11 11 11 11 11 11 11 11 11 11
11 11 11 11 11 11 11 11 11 11 11 11 11 11 11 11 11 3 10 8 10 8 10 8 10 8 10 8 10 8 10 8 10 8 3 11 11 11 11 11 11 11 11 11 11 11 11 11 11 11 11 11 11
11 11 11 11 11 11 11 11 11 11 11 11 11 11 11 11 11 3 10 8 10 8 10 8 10 8 10 8 10 8 10 8 10 8 3 11 11 11 11 11 11 11 11 11 11 11 11 11 11 11 11 11 11
11 11 11 11 11 11 11 11 11 11 11 11 11 11 11 11 11 3 10 8 10 8 10 8 10 8 10 8 10 8 10 8 10 8 3 11 11 11 11 11 11 11 11 11 11 11 11 11 11 11 11 11 11
11 11 11 11 11 11 11 11 11 11 11 11 11 3 3 3 3 3 3 3 3 3 3 3 3 10 10 3 3 3 3 3 3 3 3 3 3 3 3 11 11 11 11 11 11 11 11 11 11 11 11 11 11
11 11 11 11 11 11 11 11 11 11 11 11 11 3 8 8 8 8 8 8 8 3 10 10 10 10 10 10 10 10 3 8 8 8 8 8 8 8 3 11 11 11 11 11 11 11 11 11 11 11 11 11 11
11 11 11 11 11 11 11 11 11 11 11 11 11 3 8 8 8 8 8 8 8 3 10 8 8 10 10 8 8 10 3 8 8 8 8 8 8 8 3 11 11 11 11 11 11 11 11 11 11 11 11 11 11
11 11 11 11 11 11 11 11 11 11 11 11 11 3 9 9 8 9 8 9 9 3 10 8 8 10 10 8 8 10 3 9 9 8 9 8 9 9 3 11 11 11 11 11 11 11 11 11 11 11 11 11 11
11 11 11 11 11 11 11 11 11 11 11 11 11 3 8 8 8 8 8 8 8 8 10 10 10 10 10 10 10 10 8 8 8 8 8 8 8 8 3 11 11 11 11 11 11 11 11 11 11 11 11 11 11
11 11 11 11 11 11 11 11 11 11 11 11 11 3 8 8 8 8 8 8 8 8 10 10 10 10 10 10 10 10 8 8 8 8 8 8 8 8 3 11 11 11 11 11 11 11 11 11 11 11 11 11 11
11 11 11 11 11 11 11 11 11 11 11 11 11 3 9 9 8 9 8 9 9 3 10 8 8 10 10 8 8 10 3 9 9 8 9 8 9 9 3 11 11 11 11 11 11 11 11 11 11 11 11 11 11
11 11 11 11 11 11 11 11 11 11 11 11 11 3 8 8 8 8 8 8 8 3 10 8 8 10 10 8 8 10 3 8 8 8 8 8 8 8 3 11 11 11 11 11 11 11 11 11 11 11 11 11 11
11 11 11 11 11 11 11 11 11 11 11 11 11 3 9 9 8 9 8 9 9 3 10 10 10 10 10 10 10 10 3 9 9 8 9 8 9 9 3 11 11 11 11 11 11 11 11 11 11 11 11 11 11
11 11 11 11 11 11 11 11 11 11 11 11 11 3 3 3 3 3 3 3 3 3 10 10 10 10 10 10 10 10 3 3 3 3 3 3 3 3 3 11 11 11 11 11 11 11 11 11 11 11 11 11 11
11 11 11 11 11 11 11 11 11 11 11 11 11 3 8 8 8 8 8 8 8 3 10 10 10 10 10 10 10 10 3 8 8 8 8 8 8 8 3 11 11 11 11 11 11 11 11 11 11 11 11 11 11
11 11 11 11 11 11 11 11 11 11 11 11 11 3 8 8 8 8 8 8 8 3 10 8 8 10 10 8 8 10 3 8 8 8 8 8 8 8 3 11 11 11 11 11 11 11 11 11 11 11 11 11 11
11 11 11 11 11 11 11 11 11 11 11 11 11 3 8 8 8 8 8 8 8 8 10 8 8 10 10 8 8 10 8 8 8 8 8 8 8 8 3 11 11 11 11 11 11 11 11 11 11 11 11 11 11
11 11 11 11 11 11 11 11 11 11 11 11 11 3 9 9 9 8 9 9 9 8 10 10 10 10 10 10 10 10 8 9 9 9 8 9 9 9 3 11 11 11 11 11 11 11 11 11 11 11 11 11 11
11 11 11 11 11 11 11 11 11 11 11 11 11 3 8 8 8 8 8 8 8 3 10 10 10 10 10 10 10 10 3 8 8 8 8 8 8 8 3 11 11 11 11 11 11 11 11 11 11 11 11 11 11
11 11 11 11 11 11 11 11 11 11 11 11 11 3 9 9 9 8 9 9 9 3 10 8 8 10 10 8 8 10 3 9 9 9 8 9 9 9 3 11 11 11 11 11 11 11 11 11 11 11 11 11 11
11 11 11 11 11 11 11 11 11 11 11 11 11 3 3 3 3 3 3 3 3 3 10 8 8 10 10 8 8 10 3 3 3 3 3 3 3 3 3 11 11 11 11 11 11 11 11 11 11 11 11 11 11
11 11 11 11 11 11 11 11 11 11 11 11 11 3 9 9 9 9 9 9 9 8 10 10 10 10 10 10 10 10 8 9 9 9 9 9 9 9 3 11 11 11 11 11 11 11 11 11 11 11 11 11 11
11 11 11 11 11 11 11 11 11 11 11 11 11 3 8 8 8 8 8 8 8 8 10 10 10 10 10 10 10 10 8 8 8 8 8 8 8 8 3 11 11 11 11 11 11 11 11 11 11 11 11 11 11
11 11 11 11 11 11 11 11 11 11 11 11 11 3 9 8 9 8 9 8 9 3 3 3 3 10 10 3 3 3 3 9 8 9 8 9 8 9 3 11 11 11 11 11 11 11 11 11 11 11 11 11 11
11 11 11 11 11 11 11 11 11 11 11 11 11 3 8 8 8 8 8 8 8 3 11 11 11 13 13 11 11 11 3 8 8 8 8 8 8 8 3 11 11 11 11 11 11 11 11 11 11 11 11 11 11
11 11 11 11 11 11 11 11 11 11 11 11 11 3 9 8 9 8 9 8 9 3 11 12 11 13 13 11 12 11 3 9 8 9 8 9 8 9 3 11 11 11 11 11 11 11 11 11 11 11 11 11 11
11 11 11 11 11 11 11 11 11 11 11 11 11 3 8 8 8 8 8 8 8 3 11 12 11 13 13 11 12 11 3 8 8 8 8 8 8 8 3 11 11 11 11 11 11 11 11 11 11 11 11 11 11
11 11 11 11 11 11 11 11 11 11 11 11 11 3 8 8 8 8 8 8 8 3 11 12 11 13 13 11 12 11 3 8 8 8 8 8 8 8 3 11 11 11 11 11 11 11 11 11 11 11 11 11 11
11 11 11 11 11 11 11 11 11 11 11 11 11 3 3 3 3 3 3 3 3 3 11 11 11 13 13 11 11 11 3 3 3 3 3 3 3 3 3 11 11 11 11 11 11 11 11 11 11 11 11 11 11
11 11 11 11 11 11 11 11 11 11 11 11 11 11 11 11 11 11 11 11 11 11 11 11 11 13 13 11 11 11 11 11 11 11 11 11 11 11 11 11 11 11 11 11 11 11 11 11 11 11 11 11 11
11 11 11 11 11 11 11 12 12 12 12 12 12 12 12 12 12 12 12 12 12 12 12 12 12 13 13 12 12 12 12 12 12 12 12 12 12 12 12 12 12 12 12 12 12 12 11 11 11 11 11 11 11
11 11 11 11 11 11 11 12 12 12 12 12 12 12 12 12 12 11 11 11 12 12 12 13 13 13 13 12 12 12 12 12 14 14 14 14 14 12 12 12 12 12 12 12 12 12 11 11 11 11 11 11 11
11 11 11 11 11 11 11 12 12 12 12 12 12 12 12 12 12 11 11 11 12 12 12 13 12 12 12 12 12 12 12 12 14 14 14 14 14 12 12 12 12 12 12 12 12 12 11 11 11 11 11 11 11
11 11 11 11 11 11 11 12 12 12 12 12 12 12 12 12 12 11 11 11 12 12 12 13 13 13 13 12 12 12 12 12 14 14 14 14 14 12 12 12 12 12 12 12 12 12 11 11 11 11 11 11 11
11 11 11 11 11 11 11 12 12 12 12 12 12 12 12 12 12 12 12 12 12 12 12 12 12 12 13 12 12 12 12 12 14 14 14 14 14 12 12 12 12 12 12 12 12 12 11 11 11 11 11 11 11
11 11 11 11 11 11 11 12 12 12 14 14 14 12 12 12 13 13 13 13 13 13 13 13 13 13 13 12 11 11 12 12 13 13 13 13 13 12 12 12 12 12 12 12 12 12 11 11 11 11 11 11 11
11 11 11 11 11 11 11 12 12 12 14 14 14 12 12 12 13 12 12 12 12 12 12 12 12 12 12 12 11 11 12 12 13 12 12 13 13 12 12 12 12 12 12 12 12 12 11 11 11 11 11 11 11
11 11 11 11 11 11 11 12 12 12 14 14 14 12 12 12 13 12 12 12 12 12 12 12 12 12 12 12 12 12 12 12 13 12 12 13 13 12 12 12 12 12 12 12 12 12 11 11 11 11 11 11 11
11 11 11 11 11 11 11 12 12 12 14 14 14 12 12 12 13 13 13 13 13 13 13 13 13 13 13 13 13 13 13 13 13 12 12 13 13 12 12 12 12 12 12 12 12 12 11 11 11 11 11 11 11
11 11 11 11 11 11 11 12 12 12 12 12 12 12 12 12 12 12 12 12 12 12 12 12 12 12 12 12 12 12 12 12 12 12 12 13 13 12 12 12 12 12 12 12 12 12 11 11 11 11 11 11 11
11 11 11 11 11 11 11 11 11 11 11 11 11 3 3 3 3 3 3 3 3 3 3 3 3 3 3 3 3 3 3 3 3 3 3 1 1 3 3 11 11 11 11 11 11 11 11 11 11 11 11 11 11
11 11 11 11 11 11 11 11 11 11 11 11 11 3 1 2 1 2 1 2 1 2 1 2 1 2 1 2 1 2 1 2 1 2 1 2 1 2 3 11 11 11 11 11 11 11 11 11 11 11 11 11 11
11 11 11 11 11 11 11 11 11 11 11 11 11 3 2 1 2 1 2 1 2 1 2 1 2 1 2 1 2 1 2 1 2 1 2 1 2 1 3 11 11 11 11 11 11 11 11 11 11 11 11 11 11
11 11 11 11 11 11 11 11 11 11 11 11 11 3 1 2 1 2 1 2 1 2 1 2 1 2 1 2 1 2 1 2 1 2 1 2 1 2 3 11 11 11 11 11 11 11 11 11 11 11 11 11 11
11 11 11 11 11 11 11 11 11 11 11 11 11 3 2 1 2 1 2 1 2 1 2 1 2 1 2 1 2 1 2 1 2 1 2 1 2 1 3 11 11 11 11 11 11 11 11 11 11 11 11 11 11
11 11 11 11 11 11 11 11 11 11 11 11 11 3 1 2 1 2 1 2 1 2 1 2 1 2 1 2 1 2 1 2 1 2 1 2 1 2 3 11 11 11 11 11 11 11 11 11 11 11 11 11 11
11 11 11 11 11 11 11 11 11 11 11 11 11 3 2 1 2 1 2 1 2 1 2 1 2 1 2 1 2 1 2 1 2 1 2 1 2 1 3 11 11 11 11 11 11 11 11 11 11 11 11 11 11
11 11 11 11 11 11 11 11 11 11 11 11 11 3 1 2 1 2 1 2 1 2 1 2 1 2 1 2 1 2 1 2 1 2 1 2 1 2 3 11 11 11 11 11 11 11 11 11 11 11 11 11 11
11 11 11 11 11 11 11 11 11 11 11 11 11 3 2 1 2 1 2 1 2 1 2 1 2 1 2 1 2 1 2 1 2 1 2 1 2 1 3 11 11 11 11 11 11 11 11 11 11 11 11 11 11
11 11 11 11 11 11 11 11 11 11 11 11 11 3 3 3 3 3 3 3 3 3 3 3 3 1 1 3 3 3 3 3 3 3 3 3 3 3 3 11 11 11 11 11 11 11 11 11 11 11 11 11 11
11 11 11 11 11 11 11 11 11 11 11 11 11 3 2 2 2 2 2 2 2 2 2 2 3 1 1 3 2 2 2 2 2 2 2 2 2 2 3 11 11 11 11 11 11 11 11 11 11 11 11 11 11
11 11 11 11 11 11 11 11 11 11 11 11 11 3 2 2 2 2 2 2 2 2 2 2 3 1 1 3 2 2 2 2 2 2 2 2 2 2 3 11 11 11 11 11 11 11 11 11 11 11 11 11 11
11 11 11 11 11 11 11 11 11 11 11 11 11 3 2 4 4 4 2 2 4 4 4 2 2 1 1 2 2 4 2 4 2 4 2 4 2 4 3 11 11 11 11 11 11 11 11 11 11 11 11 11 11
11 11 11 11 11 11 11 11 11 11 11 11 11 3 2 2 2 2 2 2 2 2 2 2 2 1 1 2 2 2 2 2 2 2 2 2 2 2 3 11 11 11 11 11 11 11 11 11 11 11 11 11 11
11 11 11 11 11 11 11 11 11 11 11 11 11 3 2 4 4 4 2 2 4 4 4 2 3 1 1 3 2 4 2 4 2 4 2 4 2 4 3 11 11 11 11 11 11 11 11 11 11 11 11 11 11
11 11 11 11 11 11 11 11 11 11 11 11 11 3 2 2 2 2 2 2 2 2 2 2 3 1 1 3 2 2 2 2 2 2 2 2 2 2 3 11 11 11 11 11 11 11 11 11 11 11 11 11 11
11 11 11 11 11 11 11 11 11 11 11 11 11 3 3 3 3 3 3 3 3 3 3 3 3 1 1 3 3 3 3 3 3 3 3 3 3 3 3 11 11 11 11 11 11 11 11 11 11 11 11 11 11
11 11 11 11 11 11 11 11 11 11 11 11 11 3 2 2 2 2 2 2 2 2 2 2 3 1 1 3 2 2 2 2 2 2 2 2 2 2 3 11 11 11 11 11 11 11 11 11 11 11 11 11 11
11 11 11 11 11 11 11 11 11 11 11 11 11 3 2 2 2 2 2 2 2 2 2 2 3 1 1 3 2 2 2 2 2 2 2 2 2 2 3 11 11 11 11 11 11 11 11 11 11 11 11 11 11
11 11 11 11 11 11 11 11 11 11 11 11 11 3 4 4 2 2 4 4 2 4 4 2 2 1 1 2 2 4 2 4 2 4 2 4 2 4 3 11 11 11 11 11 11 11 11 11 11 11 11 11 11
11 11 11 11 11 11 11 11 11 11 11 11 11 3 2 2 2 2 2 2 2 2 2 2 2 1 1 2 2 2 2 2 2 2 2 2 2 2 3 11 11 11 11 11 11 11 11 11 11 11 11 11 11
11 11 11 11 11 11 11 11 11 11 11 11 11 3 4 4 2 2 4 4 2 4 4 2 3 1 1 3 2 4 2 4 2 4 2 4 2 4 3 11 11 11 11 11 11 11 11 11 11 11 11 11 11
11 11 11 11 11 11 11 11 11 11 11 11 11 3 2 2 2 2 2 2 2 2 2 2 3 1 1 3 2 2 2 2 2 2 2 2 2 2 3 11 11 11 11 11 11 11 11 11 11 11 11 11 11
11 11 11 11 11 11 11 11 11 11 11 11 11 3 3 3 3 3 3 3 3 3 3 3 3 1 1 3 3 3 3 3 3 3 3 3 3 3 3 11 11 11 11 11 11 11 11 11 11 11 11 11 11
11 11 11 11 11 11 11 11 11 11 11 11 11 3 2 2 2 2 2 2 2 2 2 2 3 1 1 3 2 2 2 2 2 2 2 2 2 2 3 11 11 11 11 11 11 11 11 11 11 11 11 11 11
11 11 11 11 11 11 11 11 11 11 11 11 11 3 2 2 2 2 2 2 2 2 2 2 3 1 1 3 2 2 2 2 2 2 2 2 2 2 3 11 11 11 11 11 11 11 11 11 11 11 11 11 11
11 11 11 11 11 11 11 11 11 11 11 11 11 3 2 4 4 4 2 2 4 4 4 2 2 1 1 2 2 4 4 2 4 4 2 2 4 4 3 11 11 11 11 11 11 11 11 11 11 11 11 11 11
11 11 11 11 11 11 11 11 11 11 11 11 11 3 2 2 2 2 2 2 2 2 2 2 2 1 1 2 2 2 2 2 2 2 2 2 2 2 3 11 11 11 11 11 11 11 11 11 11 11 11 11 11
11 11 11 11 11 11 11 11 11 11 11 11 11 3 2 4 4 4 2 2 4 4 4 2 3 1 1 3 2 4 4 2 4 4 2 2 4 4 3 11 11 11 11 11 11 11 11 11 11 11 11 11 11
11 11 11 11 11 11 11 11 11 11 11 11 11 3 2 2 2 2 2 2 2 2 2 2 3 1 1 3 2 2 2 2 2 2 2 2 2 2 3 11 11 11 11 11 11 11 11 11 11 11 11 11 11
11 11 11 11 11 11 11 11 11 11 11 11 11 3 3 3 3 3 3 3 3 3 3 3 3 3 3 3 3 3 3 3 3 3 3 3 3 3 3 11 11 11 11 11 11 11 11 11 11 11 11 11 11
11 11 11 11 11 11 11 11 11 11 11 11 11 11 11 11 11 11 11 11 11 11 11 11 11 11 11 11 11 11 11 11 11 11 11 11 11 11 11 11 11 11 11 11 11 11 11 11 11 11 11 11 11
11 11 11 11 11 11 11 11 11 11 11 11 11 11 11 11 11 11 11 11 11 11 11 11 11 11 11 11 11 11 11 11 11 11 11 11 11 11 11 11 11 11 11 11 11 11 11 11 11 11 11 11 11
11 11 11 11 11 11 11 11 11 11 11 11 11 11 11 11 11 11 11 11 11 11 11 11 11 11 11 11 11 11 11 11 11 11 11 11 11 11 11 11 11 11 11 11 11 11 11 11 11 11 11 11 11
11 11 11 11 11 11 11 11 11 11 11 11 11 11 11 11 11 11 11 11 11 11 11 11 11 11 11 11 11 11 11 11 11 11 11 11 11 11 11 11 11 11 11 11 11 11 11 11 11 11 11 11 11
11 11 11 11 11 11 11 11 11 11 11 11 11 11 11 11 11 11 11 11 11 11 11 11 11 11 11 11 11 11 11 11 11 11 11 11 11 11 11 11 11 11 11 11 11 11 11 11 11 11 11 11 11
11 11 11 11 11 11 11 11 11 11 11 11 11 11 11 11 11 11 11 11 11 11 11 11 11 11 11 11 11 11 11 11 11 11 11 11 11 11 11 11 11 11 11 11 11 11 11 11 11 11 11 11 11
11 11 11 11 11 11 11 11 11 11 11 11 11 11 11 11 11 11 11 11 11 11 11 11 11 11 11 11 11 11 11 11 11 11 11 11 11 11 11 11 11 11 11 11 11 11 11 11 11 11 11 11 11
11 11 11 11 11 11 11 11 11 11 11 11 11 11 11 11 11 11 11 11 11 11 11 11 11 11 11 11 11 11 11 11 11 11 11 11 11 11 11 11 11 11 11 11 11 11 11 11 11 11 11 11 11
11 11 11 11 11 11 11 11 11 11 11 11 11 11 11 11 11 11 11 11 11 11 11 11 11 11 11 11 11 11 11 11 11 11 11 11 11 11 11 11 11 11 11 11 11 11 11 11 11 11 11 11 11
11 11 11 11 11 11 11 11 11 11 11 11 11 11 11 11 11 11 11 11 11 11 11 11 11 11 11 11 11 11 11 11 11 11 11 11 11 11 11 11 11 11 11 11 11 11 11 11 11 11 11 11 11
11 11 11 11 11 11 11 11 11 11 11 11 11 11 11 11 11 11 11 11 11 11 11 11 11 11 11 11 11 11 11 11 11 11 11 11 11 11 11 11 11 11 11 11 11 11 11 11 11 11 11 11 11
